Name,Volume,Ask Size,Ask Price,Bid Size,Bid Price,Last Price,Shares Matched,Shares Routed
UVXY,4902955,0,0.00,0,0.00,5.69,4889534,13421
VXX,1233843,0,0.00,0,0.00,12.60,1217024,16819
VIXY,1222302,0,0.00,0,0.00,10.16,1214910,7392
USHY,941032,0,0.00,0,0.00,34.50,940883,149
UVIX,923001,0,0.00,0,0.00,22.14,916883,6118
ITB,754969,0,0.00,0,0.00,66.30,722064,32905
IEFA,592065,0,0.00,0,0.00,65.80,586740,5325
SVXY,566707,0,0.00,0,0.00,61.76,563640,3067
SVIX,501159,0,0.00,0,0.00,16.00,500370,789
IGV,420715,0,0.00,0,0.00,278.99,420514,201
ARKG,348763,0,0.00,0,0.00,30.39,344955,3808
USMV,331155,0,0.00,0,0.00,71.91,325709,5446
EZU,299801,0,0.00,0,0.00,43.90,299110,691
ICSH,297949,0,0.00,0,0.00,50.17,167410,130539
GOVT,250839,0,0.00,0,0.00,22.71,247588,3251
NEAR,240885,0,0.00,0,0.00,49.58,235244,5641
INDA,224951,0,0.00,0,0.00,39.90,222522,2429
CBOE,216223,0,0.00,0,0.00,128.46,215610,613
BBEU,206998,0,0.00,0,0.00,52.80,206097,901
VNM,173953,0,0.00,0,0.00,12.08,173053,900
COWZ,150716,0,0.00,0,0.00,47.85,149811,905
FLOT,147358,0,0.00,0,0.00,50.66,144942,2416
VUSB,126432,0,0.00,0,0.00,49.05,126182,250
NOBL,112055,0,0.00,0,0.00,91.01,107802,4253
QUAL,108281,0,0.00,0,0.00,119.22,105471,2810
ECH,92800,0,0.00,0,0.00,28.25,88022,4778
ITA,92276,0,0.00,0,0.00,115.68,88379,3897
EFV,91930,0,0.00,0,0.00,49.05,87767,4163
HYD,91386,0,0.00,0,0.00,50.95,90756,630
REM,83439,0,0.00,0,0.00,24.35,83336,103
NULV,79605,0,0.00,0,0.00,34.54,78304,1301
MOAT,75615,0,0.00,0,0.00,70.91,75583,32
IDV,71217,0,0.00,0,0.00,28.39,71134,83
MTUM,68593,0,0.00,0,0.00,140.80,67798,795
PAVE,67135,0,0.00,0,0.00,28.63,65737,1398
GFEB,66166,0,0.00,0,0.00,29.04,65215,951
BBJP,63804,0,0.00,0,0.00,46.45,62002,1802
EEMV,58289,0,0.00,0,0.00,53.68,54747,3542
IYZ,54597,0,0.00,0,0.00,23.44,54557,40
GOVZ,47708,0,0.00,0,0.00,12.68,47708,0
HEFA,44366,0,0.00,0,0.00,29.24,44266,100
IEO,43556,0,0.00,0,0.00,87.18,43556,0
IAGG,41000,0,0.00,0,0.00,47.96,40409,591
GCOW,35909,0,0.00,0,0.00,33.43,35909,0
EFG,31366,0,0.00,0,0.00,89.61,30574,792
BALT,31093,0,0.00,0,0.00,26.93,26393,4700
VXZ,30709,0,0.00,0,0.00,22.87,12309,18400
CALF,30678,0,0.00,0,0.00,38.93,30478,200
PICK,27820,0,0.00,0,0.00,44.21,27586,234
IFRA,27297,0,0.00,0,0.00,38.01,27205,92
ITM,26980,0,0.00,0,0.00,45.37,26980,0
DFIC,24716,0,0.00,0,0.00,23.90,22864,1852
DISV,24357,0,0.00,0,0.00,23.93,15957,8400
FGRO,24187,0,0.00,0,0.00,13.94,24187,0
FFEB,24070,0,0.00,0,0.00,36.55,24070,0
RDVI,24055,0,0.00,0,0.00,22.38,20955,3100
BBAX,23867,0,0.00,0,0.00,50.56,23007,860
VLUE,21441,0,0.00,0,0.00,95.02,19322,2119
DIHP,20153,0,0.00,0,0.00,23.60,19740,413
EFAV,19356,0,0.00,0,0.00,65.77,19152,204
FLIA,18281,0,0.00,0,0.00,19.41,17781,500
ACWV,18185,0,0.00,0,0.00,95.07,17388,797
ARKQ,17501,0,0.00,0,0.00,48.66,17501,0
DIVB,17288,0,0.00,0,0.00,38.15,17235,53
ICF,17225,0,0.00,0,0.00,57.69,17224,1
USEP,17007,0,0.00,0,0.00,27.02,12696,4311
IYT,16933,0,0.00,0,0.00,227.85,16291,642
ICVT,16583,0,0.00,0,0.00,73.00,16483,100
OMFL,16474,0,0.00,0,0.00,46.08,16399,75
IBHE,16194,0,0.00,0,0.00,22.66,16194,0
SMOT,15870,0,0.00,0,0.00,29.37,15870,0
ESML,15802,0,0.00,0,0.00,35.66,15802,0
BBCA,15566,0,0.00,0,0.00,60.06,14894,672
ESGV,15538,0,0.00,0,0.00,69.92,15538,0
FRDM,15451,0,0.00,0,0.00,29.06,15451,0
JMST,15015,0,0.00,0,0.00,50.54,13415,1600
HEGD,14752,0,0.00,0,0.00,17.42,14752,0
AAAU,14726,0,0.00,0,0.00,18.20,14721,5
VSGX,14294,0,0.00,0,0.00,51.83,14078,216
FLHY,14180,0,0.00,0,0.00,22.19,14135,45
SLVP,13773,0,0.00,0,0.00,9.88,13773,0
PMAR,13237,0,0.00,0,0.00,31.41,13237,0
VIXM,13223,0,0.00,0,0.00,26.82,13223,0
XMPT,13205,0,0.00,0,0.00,21.33,11766,1439
LQDW,12562,0,0.00,0,0.00,33.85,12562,0
OILK,12155,0,0.00,0,0.00,42.70,12155,0
TLTW,11851,0,0.00,0,0.00,32.78,11848,3
ACIO,11703,0,0.00,0,0.00,29.54,9403,2300
PJAN,11643,0,0.00,0,0.00,32.59,11643,0
FMIL,11442,0,0.00,0,0.00,30.36,11442,0
IQDG,11409,0,0.00,0,0.00,32.56,10409,1000
CNYA,10914,0,0.00,0,0.00,33.34,10614,300
NULG,10896,0,0.00,0,0.00,52.79,10896,0
WTAI,10712,0,0.00,0,0.00,16.65,10312,400
KRUZ,10550,0,0.00,0,0.00,24.48,9370,1180
IGE,10402,0,0.00,0,0.00,39.57,10401,1
FBCG,10294,0,0.00,0,0.00,23.53,10294,0
OSCV,10265,0,0.00,0,0.00,32.46,10265,0
BUYW,9917,0,0.00,0,0.00,13.17,9917,0
ARKX,9914,0,0.00,0,0.00,13.92,9719,195
LVHI,9790,0,0.00,0,0.00,27.11,9040,750
XSEP,9345,0,0.00,0,0.00,31.78,8773,572
EMTL,9304,0,0.00,0,0.00,40.51,7467,1837
PMAY,9272,0,0.00,0,0.00,28.60,9272,0
JMUB,9026,0,0.00,0,0.00,49.70,8887,139
GDMA,8806,0,0.00,0,0.00,29.20,8806,0
DAUG,8695,0,0.00,0,0.00,31.65,8411,284
SYLD,8616,0,0.00,0,0.00,62.99,8616,0
PTLC,8543,0,0.00,0,0.00,36.96,8212,331
PFEB,8529,0,0.00,0,0.00,28.67,8429,100
EMGF,8498,0,0.00,0,0.00,41.60,6696,1802
RPHS,8475,0,0.00,0,0.00,8.39,8475,0
RSBT,8452,0,0.00,0,0.00,20.00,8252,200
FOCT,8219,0,0.00,0,0.00,34.26,8219,0
MLN,8090,0,0.00,0,0.00,17.46,8090,0
REGL,8066,0,0.00,0,0.00,74.02,8011,55
PTEU,8054,0,0.00,0,0.00,25.39,8054,0
DAPR,8005,0,0.00,0,0.00,29.68,8005,0
NUMV,7838,0,0.00,0,0.00,30.96,7778,60
KNG,7784,0,0.00,0,0.00,51.65,7784,0
JEMA,7750,0,0.00,0,0.00,35.79,7250,500
NANC,7583,0,0.00,0,0.00,24.94,5764,1819
GHTA,7561,0,0.00,0,0.00,25.89,7561,0
GVI,7484,0,0.00,0,0.00,102.29,7484,0
ICOW,7472,0,0.00,0,0.00,29.08,7389,83
LQDI,7364,0,0.00,0,0.00,25.35,7364,0
HYDB,6992,0,0.00,0,0.00,43.57,6992,0
BBIN,6783,0,0.00,0,0.00,53.05,6783,0
PTMC,6698,0,0.00,0,0.00,33.44,6698,0
PDEC,6686,0,0.00,0,0.00,30.76,6686,0
IBML,6683,0,0.00,0,0.00,25.33,6683,0
FJAN,6669,0,0.00,0,0.00,34.10,6669,0
EMHY,6641,0,0.00,0,0.00,34.70,6641,0
BBUS,6620,0,0.00,0,0.00,71.69,6620,0
UFEB,6467,0,0.00,0,0.00,26.05,6467,0
EPRF,6317,0,0.00,0,0.00,19.17,3753,2564
FPRO,6241,0,0.00,0,0.00,21.51,5241,1000
XJH,6193,0,0.00,0,0.00,35.39,6193,0
GDE,6159,0,0.00,0,0.00,22.21,4628,1531
GJAN,5888,0,0.00,0,0.00,30.30,5888,0
FDG,5855,0,0.00,0,0.00,55.70,5755,100
FDRV,5715,0,0.00,0,0.00,18.43,5649,66
XBTF,5676,0,0.00,0,0.00,24.67,2722,2954
NUEM,5555,0,0.00,0,0.00,26.65,5355,200
BBSA,5508,0,0.00,0,0.00,46.97,5508,0
CEMB,5488,0,0.00,0,0.00,43.06,5488,0
XVV,5419,0,0.00,0,0.00,29.98,5220,199
VOTE,5333,0,0.00,0,0.00,46.27,5333,0
BMAR,5309,0,0.00,0,0.00,33.65,5309,0
JCPB,5271,0,0.00,0,0.00,46.22,4639,632
FCPI,5221,0,0.00,0,0.00,31.46,4820,401
IBHD,5149,0,0.00,0,0.00,22.94,5148,1
IBHF,5107,0,0.00,0,0.00,22.41,5107,0
BJAN,5100,0,0.00,0,0.00,34.34,5100,0
DFIS,4938,0,0.00,0,0.00,22.90,3553,1385
SHYD,4879,0,0.00,0,0.00,22.16,4879,0
PSEP,4878,0,0.00,0,0.00,30.17,4878,0
PSMG,4841,0,0.00,0,0.00,16.75,4841,0
MSTB,4706,0,0.00,0,0.00,25.56,4706,0
IBMO,4596,0,0.00,0,0.00,25.09,4196,400
DOCT,4567,0,0.00,0,0.00,32.16,4567,0
DDWM,4520,0,0.00,0,0.00,31.15,4520,0
IBHC,4417,0,0.00,0,0.00,23.59,4417,0
OUSA,4395,0,0.00,0,0.00,41.38,4395,0
IYLD,4346,0,0.00,0,0.00,19.37,4260,86
SECT,4346,0,0.00,0,0.00,40.68,4346,0
IBMP,4329,0,0.00,0,0.00,25.00,3729,600
PAPR,4204,0,0.00,0,0.00,28.96,4204,0
RDFI,4200,0,0.00,0,0.00,22.86,4000,200
SMMD,4188,0,0.00,0,0.00,57.05,3988,200
ZECP,4178,0,0.00,0,0.00,23.35,4178,0
VCEB,4170,0,0.00,0,0.00,60.84,4170,0
TMFC,4050,0,0.00,0,0.00,33.05,3850,200
UJAN,4050,0,0.00,0,0.00,30.53,4050,0
QVOY,4043,0,0.00,0,0.00,25.02,4043,0
CEFS,4017,0,0.00,0,0.00,18.15,4017,0
IBHI,4000,0,0.00,0,0.00,21.67,4000,0
BBRE,3932,0,0.00,0,0.00,87.32,3932,0
PSMM,3901,0,0.00,0,0.00,13.73,3901,0
SMMV,3898,0,0.00,0,0.00,36.10,3898,0
FLQL,3881,0,0.00,0,0.00,40.35,3881,0
SVAL,3843,0,0.00,0,0.00,29.83,3843,0
IBMM,3807,0,0.00,0,0.00,25.63,3356,451
GSUS,3783,0,0.00,0,0.00,54.34,3683,100
GMOM,3781,0,0.00,0,0.00,28.12,3781,0
KJAN,3773,0,0.00,0,0.00,31.38,3073,700
PJUL,3666,0,0.00,0,0.00,30.99,3666,0
NUMG,3656,0,0.00,0,0.00,38.13,3655,1
POCT,3627,0,0.00,0,0.00,30.99,3627,0
RULE,3600,0,0.00,0,0.00,19.42,3600,0
BAUG,3537,0,0.00,0,0.00,30.89,3537,0
TMFM,3515,0,0.00,0,0.00,22.72,3515,0
MFUL,3510,0,0.00,0,0.00,21.50,3510,0
NUSC,3441,0,0.00,0,0.00,37.11,3367,74
NUDM,3375,0,0.00,0,0.00,27.69,3375,0
FCLD,3340,0,0.00,0,0.00,16.90,3340,0
TAIL,3334,0,0.00,0,0.00,14.58,3334,0
DNOV,3295,0,0.00,0,0.00,33.54,3295,0
DDLS,3240,0,0.00,0,0.00,31.90,3240,0
DRSK,3225,0,0.00,0,0.00,25.60,3125,100
ADME,3214,0,0.00,0,0.00,34.06,3214,0
KAPR,3187,0,0.00,0,0.00,26.26,3146,41
JPIB,3125,0,0.00,0,0.00,46.82,2825,300
FYLD,3093,0,0.00,0,0.00,25.71,3093,0
FLQM,3083,0,0.00,0,0.00,43.60,3083,0
TDV,3036,0,0.00,0,0.00,59.42,3036,0
MPRO,3035,0,0.00,0,0.00,25.35,2858,177
IBMN,2971,0,0.00,0,0.00,26.20,2971,0
PNOV,2922,0,0.00,0,0.00,31.15,2922,0
QTJA,2905,0,0.00,0,0.00,18.26,2905,0
PAUG,2896,0,0.00,0,0.00,29.08,2896,0
XDEC,2829,0,0.00,0,0.00,30.67,2829,0
DINT,2803,0,0.00,0,0.00,18.99,2803,0
VAMO,2740,0,0.00,0,0.00,26.98,2740,0
SMDV,2724,0,0.00,0,0.00,65.10,2650,74
IYJ,2716,0,0.00,0,0.00,100.01,2716,0
BUFF,2594,0,0.00,0,0.00,35.28,1594,1000
FLDR,2584,0,0.00,0,0.00,49.88,2584,0
QVAL,2541,0,0.00,0,0.00,34.01,2541,0
XSHD,2540,0,0.00,0,0.00,18.37,2540,0
PBSM,2515,0,0.00,0,0.00,34.75,2515,0
NETZ,2503,0,0.00,0,0.00,49.41,2503,0
IDME,2483,0,0.00,0,0.00,19.67,2300,183
IMOM,2471,0,0.00,0,0.00,25.99,2471,0
PAWZ,2398,0,0.00,0,0.00,51.80,2398,0
FSMO,2354,0,0.00,0,0.00,21.80,1465,889
EYLD,2350,0,0.00,0,0.00,29.15,2350,0
JUCY,2295,0,0.00,0,0.00,25.08,2095,200
VFVA,2253,0,0.00,0,0.00,105.09,2253,0
MRSK,2237,0,0.00,0,0.00,26.26,2237,0
DSEP,2233,0,0.00,0,0.00,31.41,2233,0
GSEW,2223,0,0.00,0,0.00,60.85,2223,0
FMAY,2200,0,0.00,0,0.00,36.15,2200,0
UJUN,2182,0,0.00,0,0.00,27.21,2182,0
FLBL,2142,0,0.00,0,0.00,23.76,2141,1
IGRO,2116,0,0.00,0,0.00,60.50,2116,0
FJUL,2111,0,0.00,0,0.00,35.43,2111,0
BUFD,2103,0,0.00,0,0.00,20.02,2103,0
IZRL,2103,0,0.00,0,0.00,17.99,2103,0
ATMP,2101,0,0.00,0,0.00,19.25,2101,0
IBHH,2101,0,0.00,0,0.00,22.10,2101,0
IGEB,2085,0,0.00,0,0.00,43.55,2085,0
DWLD,2029,0,0.00,0,0.00,27.00,2029,0
FAPR,2025,0,0.00,0,0.00,30.23,2025,0
FBCV,2004,0,0.00,0,0.00,28.09,2004,0
EDEN,2003,0,0.00,0,0.00,102.51,2003,0
FFTI,1999,0,0.00,0,0.00,20.35,1999,0
PSMB,1978,0,0.00,0,0.00,14.83,1878,100
TMFG,1972,0,0.00,0,0.00,24.87,1972,0
PRNT,1971,0,0.00,0,0.00,22.80,1971,0
KJUL,1970,0,0.00,0,0.00,25.43,1970,0
LEAD,1931,0,0.00,0,0.00,51.65,1931,0
HYHG,1919,0,0.00,0,0.00,59.05,1919,0
DFRA,1893,0,0.00,0,0.00,26.42,1893,0
AFIF,1873,0,0.00,0,0.00,8.83,1873,0
BUFR,1857,0,0.00,0,0.00,22.90,1857,0
DFEB,1851,0,0.00,0,0.00,32.95,1851,0
MOHR,1847,0,0.00,0,0.00,19.40,1847,0
TRTY,1825,0,0.00,0,0.00,25.02,1825,0
FDHT,1803,0,0.00,0,0.00,19.70,1272,531
FCTR,1775,0,0.00,0,0.00,27.69,1775,0
BUFT,1757,0,0.00,0,0.00,18.71,1757,0
IVAL,1676,0,0.00,0,0.00,23.43,1676,0
XBJA,1660,0,0.00,0,0.00,22.83,1660,0
PJUN,1655,0,0.00,0,0.00,30.38,1655,0
SMIN,1651,0,0.00,0,0.00,50.35,1651,0
VFMV,1646,0,0.00,0,0.00,99.90,1646,0
HCRB,1637,0,0.00,0,0.00,34.28,1637,0
JBBB,1636,0,0.00,0,0.00,46.54,1636,0
TMAT,1603,0,0.00,0,0.00,13.57,1603,0
EWUS,1600,0,0.00,0,0.00,33.06,1600,0
SEPZ,1600,0,0.00,0,0.00,30.30,1600,0
UMAR,1600,0,0.00,0,0.00,28.15,1600,0
IVSG,1589,0,0.00,0,0.00,9.99,1589,0
OGIG,1582,0,0.00,0,0.00,26.89,1582,0
TYA,1555,0,0.00,0,0.00,14.75,1348,207
VFMF,1541,0,0.00,0,0.00,102.79,1541,0
QDEC,1540,0,0.00,0,0.00,19.78,1540,0
FPFD,1500,0,0.00,0,0.00,20.98,1500,0
NURE,1465,0,0.00,0,0.00,31.30,1465,0
FJUN,1459,0,0.00,0,0.00,37.33,1459,0
WFHY,1454,0,0.00,0,0.00,43.80,1453,1
LYFE,1429,0,0.00,0,0.00,30.89,1429,0
FDEV,1409,0,0.00,0,0.00,25.33,1409,0
EGIS,1360,0,0.00,0,0.00,33.85,1360,0
MSVX,1324,0,0.00,0,0.00,24.38,1324,0
HYGW,1319,0,0.00,0,0.00,36.20,1319,0
UJUL,1312,0,0.00,0,0.00,26.50,1312,0
USMF,1309,0,0.00,0,0.00,38.48,1309,0
NJAN,1302,0,0.00,0,0.00,36.48,402,900
BOXX,1298,0,0.00,0,0.00,100.74,1298,0
BFEB,1294,0,0.00,0,0.00,31.24,1294,0
HYMU,1287,0,0.00,0,0.00,21.15,1287,0
IGHG,1266,0,0.00,0,0.00,72.04,1266,0
PBND,1266,0,0.00,0,0.00,21.71,1266,0
FRNW,1254,0,0.00,0,0.00,22.40,1254,0
HYIN,1215,0,0.00,0,0.00,18.94,1045,170
INTL,1181,0,0.00,0,0.00,20.35,581,600
SMB,1176,0,0.00,0,0.00,16.77,1176,0
OBND,1162,0,0.00,0,0.00,25.63,1162,0
GHYG,1138,0,0.00,0,0.00,41.47,1138,0
BUFG,1135,0,0.00,0,0.00,18.59,1135,0
DFNL,1132,0,0.00,0,0.00,28.99,1132,0
MEAR,1103,0,0.00,0,0.00,49.73,1103,0
FLV,1083,0,0.00,0,0.00,59.25,1083,0
HEEM,1062,0,0.00,0,0.00,23.99,1062,0
SUPP,1055,0,0.00,0,0.00,49.17,1055,0
GVAL,1054,0,0.00,0,0.00,20.53,1054,0
VFMO,1034,0,0.00,0,0.00,114.70,986,48
MOTI,1024,0,0.00,0,0.00,31.70,1024,0
THY,1010,0,0.00,0,0.00,22.41,1010,0
IEDI,1007,0,0.00,0,0.00,37.68,1007,0
EMDV,1002,0,0.00,0,0.00,48.03,1002,0
PBL,1002,0,0.00,0,0.00,24.77,1002,0
YDEC,1000,0,0.00,0,0.00,21.01,1000,0
VEGN,998,0,0.00,0,0.00,34.01,998,0
JCPI,994,0,0.00,0,0.00,46.42,994,0
OMFS,994,0,0.00,0,0.00,37.03,984,10
BLDG,988,0,0.00,0,0.00,26.76,988,0
PSFF,979,0,0.00,0,0.00,22.49,979,0
SPCZ,941,0,0.00,0,0.00,26.00,941,0
BBHY,935,0,0.00,0,0.00,43.67,935,0
PBTP,934,0,0.00,0,0.00,24.48,934,0
OUSM,924,0,0.00,0,0.00,35.97,924,0
VMOT,901,0,0.00,0,0.00,23.84,501,400
TILT,899,0,0.00,0,0.00,157.15,899,0
EUDV,893,0,0.00,0,0.00,43.48,893,0
QJUN,871,0,0.00,0,0.00,19.09,871,0
EFAD,849,0,0.00,0,0.00,36.73,849,0
FNOV,838,0,0.00,0,0.00,36.75,838,0
GSST,820,0,0.00,0,0.00,49.89,820,0
FMAG,819,0,0.00,0,0.00,18.52,818,1
STOT,776,0,0.00,0,0.00,46.38,776,0
UMAY,765,0,0.00,0,0.00,26.51,765,0
DMAR,764,0,0.00,0,0.00,30.21,764,0
TOKE,750,0,0.00,0,0.00,6.83,750,0
BNOV,740,0,0.00,0,0.00,30.86,740,0
WEED,732,0,0.00,0,0.00,5.42,732,0
BJUN,725,0,0.00,0,0.00,31.55,725,0
BDEC,718,0,0.00,0,0.00,33.04,718,0
BMAY,718,0,0.00,0,0.00,29.85,718,0
TBJL,715,0,0.00,0,0.00,19.68,715,0
CLSE,690,0,0.00,0,0.00,14.73,690,0
NOCT,655,0,0.00,0,0.00,37.32,655,0
BJUL,646,0,0.00,0,0.00,32.03,646,0
AESR,639,0,0.00,0,0.00,11.63,639,0
GDMN,638,0,0.00,0,0.00,22.44,638,0
FAUG,630,0,0.00,0,0.00,35.71,629,1
NJUL,621,0,0.00,0,0.00,45.37,121,500
UAUG,619,0,0.00,0,0.00,26.60,619,0
FUNL,612,0,0.00,0,0.00,33.93,612,0
MAGA,602,0,0.00,0,0.00,39.14,602,0
XDQQ,600,0,0.00,0,0.00,21.97,600,0
IBMQ,594,0,0.00,0,0.00,25.06,594,0
DURA,572,0,0.00,0,0.00,31.53,572,0
BOCT,565,0,0.00,0,0.00,32.92,565,0
ENOR,565,0,0.00,0,0.00,24.22,565,0
FEBZ,560,0,0.00,0,0.00,28.50,560,0
MOTG,560,0,0.00,0,0.00,33.58,560,0
MBCC,547,0,0.00,0,0.00,24.32,547,0
GLOV,536,0,0.00,0,0.00,39.35,536,0
FFHG,534,0,0.00,0,0.00,32.42,534,0
GLDB,524,0,0.00,0,0.00,19.27,524,0
FFTG,521,0,0.00,0,0.00,24.26,521,0
XDAT,501,0,0.00,0,0.00,16.20,501,0
NAPR,500,0,0.00,0,0.00,37.16,500,0
XTOC,500,0,0.00,0,0.00,22.23,500,0
VFQY,485,0,0.00,0,0.00,110.57,485,0
GSID,478,0,0.00,0,0.00,50.29,478,0
CVAR,473,0,0.00,0,0.00,24.69,473,0
PSFD,470,0,0.00,0,0.00,24.93,470,0
EWGS,444,0,0.00,0,0.00,61.66,444,0
IETC,422,0,0.00,0,0.00,43.70,422,0
SATO,421,0,0.00,0,0.00,6.17,421,0
SHAG,413,0,0.00,0,0.00,46.66,413,0
HYXU,406,0,0.00,0,0.00,45.38,406,0
OEUR,405,0,0.00,0,0.00,25.55,405,0
ISDB,400,0,0.00,0,0.00,24.98,400,0
QMAR,400,0,0.00,0,0.00,20.77,400,0
ESGG,392,0,0.00,0,0.00,128.07,392,0
BAPR,390,0,0.00,0,0.00,32.27,390,0
DUSA,387,0,0.00,0,0.00,29.16,139,248
DJAN,362,0,0.00,0,0.00,30.55,362,0
FDEM,359,0,0.00,0,0.00,21.84,359,0
XSHQ,355,0,0.00,0,0.00,34.90,355,0
RESE,351,0,0.00,0,0.00,27.98,351,0
FDEC,341,0,0.00,0,0.00,32.93,341,0
HELX,334,0,0.00,0,0.00,30.36,334,0
GEMD,333,0,0.00,0,0.00,39.67,244,89
GTIP,327,0,0.00,0,0.00,48.73,327,0
DDEC,321,0,0.00,0,0.00,31.38,321,0
XDOC,318,0,0.00,0,0.00,22.49,318,0
TMDV,313,0,0.00,0,0.00,47.32,313,0
BRLN,300,0,0.00,0,0.00,52.33,300,0
XDSQ,300,0,0.00,0,0.00,25.55,300,0
UAPR,298,0,0.00,0,0.00,24.91,298,0
DJUL,287,0,0.00,0,0.00,31.78,287,0
PIT,285,0,0.00,0,0.00,48.80,285,0
DMAY,273,0,0.00,0,0.00,32.01,273,0
MDEV,254,0,0.00,0,0.00,19.50,254,0
FIBR,251,0,0.00,0,0.00,83.81,251,0
PWS,243,0,0.00,0,0.00,28.00,243,0
MSMR,235,0,0.00,0,0.00,23.00,235,0
BSEP,230,0,0.00,0,0.00,31.46,230,0
XJR,209,0,0.00,0,0.00,35.85,209,0
QMOM,203,0,0.00,0,0.00,45.20,202,1
KCAL,201,0,0.00,0,0.00,25.58,201,0
FLQS,200,0,0.00,0,0.00,35.30,200,0
WLDR,200,0,0.00,0,0.00,25.09,200,0
TMFS,191,0,0.00,0,0.00,26.65,191,0
FSEP,188,0,0.00,0,0.00,34.59,188,0
MINN,182,0,0.00,0,0.00,21.72,182,0
ROMO,179,0,0.00,0,0.00,24.91,179,0
UNOV,173,0,0.00,0,0.00,28.44,173,0
FMAR,171,0,0.00,0,0.00,32.52,171,0
FFSG,170,0,0.00,0,0.00,31.74,170,0
LKOR,169,0,0.00,0,0.00,42.30,169,0
PBEE,159,0,0.00,0,0.00,22.72,159,0
WBAT,155,0,0.00,0,0.00,35.50,155,0
DALT,146,0,0.00,0,0.00,8.57,146,0
SANE,146,0,0.00,0,0.00,24.40,146,0
BLKC,139,0,0.00,0,0.00,10.60,139,0
NUDV,128,0,0.00,0,0.00,24.30,128,0
WUGI,127,0,0.00,0,0.00,36.01,127,0
WDNA,123,0,0.00,0,0.00,17.33,123,0
HAUS,114,0,0.00,0,0.00,16.39,114,0
BUFB,112,0,0.00,0,0.00,24.03,112,0
RESD,111,0,0.00,0,0.00,26.87,111,0
IDHD,109,0,0.00,0,0.00,23.98,109,0
HIDE,107,0,0.00,0,0.00,23.38,107,0
IVDG,107,0,0.00,0,0.00,10.17,107,0
QLC,104,0,0.00,0,0.00,44.62,104,0
YPS,104,0,0.00,0,0.00,21.96,104,0
KWT,103,0,0.00,0,0.00,33.08,103,0
MOTE,102,0,0.00,0,0.00,23.26,102,0
PSMC,102,0,0.00,0,0.00,12.10,102,0
QPFF,102,0,0.00,0,0.00,36.02,2,100
HYBL,101,0,0.00,0,0.00,27.48,101,0
RSEE,101,0,0.00,0,0.00,24.85,101,0
DWAT,100,0,0.00,0,0.00,10.26,100,0
ENAV,100,0,0.00,0,0.00,25.04,100,0
ESCR,100,0,0.00,0,0.00,18.00,100,0
MRGR,100,0,0.00,0,0.00,38.34,100,0
RODE,100,0,0.00,0,0.00,25.02,100,0
SEIM,100,0,0.00,0,0.00,25.24,100,0
UOCT,100,0,0.00,0,0.00,28.05,100,0
XUSP,100,0,0.00,0,0.00,25.48,100,0
YSEP,100,0,0.00,0,0.00,18.97,100,0
RYSE,91,0,0.00,0,0.00,27.84,91,0
MAAX,90,0,0.00,0,0.00,20.74,90,0
EAOA,83,0,0.00,0,0.00,28.94,83,0
HFGO,81,0,0.00,0,0.00,12.95,81,0
PBUS,80,0,0.00,0,0.00,39.86,80,0
GAA,76,0,0.00,0,0.00,27.34,76,0
ESG,73,0,0.00,0,0.00,96.38,73,0
CSM,71,0,0.00,0,0.00,47.56,71,0
EFNL,67,0,0.00,0,0.00,38.45,67,0
DBOC,64,0,0.00,0,0.00,28.93,64,0
APRZ,62,0,0.00,0,0.00,26.26,62,0
QTJL,60,0,0.00,0,0.00,21.86,60,0
STLG,53,0,0.00,0,0.00,31.68,53,0
VWID,51,0,0.00,0,0.00,25.47,51,0
SEIV,50,0,0.00,0,0.00,25.04,50,0
SHDG,47,0,0.00,0,0.00,21.86,47,0
XJUN,47,0,0.00,0,0.00,31.57,47,0
DKRB,46,0,0.00,0,0.00,26.62,46,0
QSPT,44,0,0.00,0,0.00,18.03,44,0
DBJA,40,0,0.00,0,0.00,26.19,40,0
SPYI,40,0,0.00,0,0.00,47.28,40,0
BKGI,39,0,0.00,0,0.00,28.03,39,0
GCLN,35,0,0.00,0,0.00,37.76,35,0
SFIG,33,0,0.00,0,0.00,46.82,33,0
EAOM,30,0,0.00,0,0.00,24.83,30,0
MBND,26,0,0.00,0,0.00,26.77,26,0
PXUS,25,0,0.00,0,0.00,21.84,25,0
RVRB,24,0,0.00,0,0.00,20.86,24,0
KNGS,21,0,0.00,0,0.00,18.90,21,0
PUNK,19,0,0.00,0,0.00,17.61,19,0
IVRA,18,0,0.00,0,0.00,13.82,17,1
NULC,18,0,0.00,0,0.00,33.37,18,0
BUYZ,17,0,0.00,0,0.00,23.37,17,0
DFNV,15,0,0.00,0,0.00,22.86,15,0
BOSS,14,0,0.00,0,0.00,24.56,14,0
IPDP,14,0,0.00,0,0.00,14.44,14,0
ADFI,13,0,0.00,0,0.00,8.33,13,0
IAUF,13,0,0.00,0,0.00,55.17,13,0
PEX,12,0,0.00,0,0.00,28.01,12,0
VIRS,12,0,0.00,0,0.00,28.87,12,0
DSCF,11,0,0.00,0,0.00,21.30,11,0
MBNE,11,0,0.00,0,0.00,29.31,11,0
BGLD,7,0,0.00,0,0.00,18.78,7,0
ACSI,5,0,0.00,0,0.00,44.70,5,0
TSLH,5,0,0.00,0,0.00,24.21,5,0
TTAC,5,0,0.00,0,0.00,48.04,5,0
DFND,4,0,0.00,0,0.00,34.66,4,0
DUDE,3,0,0.00,0,0.00,20.09,3,0
MSTQ,3,0,0.00,0,0.00,21.90,3,0
TTAI,2,0,0.00,0,0.00,26.60,2,0
XVOL,2,0,0.00,0,0.00,18.00,2,0
DFHY,1,0,0.00,0,0.00,20.65,1,0
EAOK,1,0,0.00,0,0.00,23.64,1,0
EAOR,1,0,0.00,0,0.00,26.98,1,0
IBHG,1,0,0.00,0,0.00,21.62,1,0
IGLD,1,0,0.00,0,0.00,18.95,1,0
IMFL,1,0,0.00,0,0.00,22.49,1,0
IQM,1,0,0.00,0,0.00,41.00,1,0
IVLC,1,0,0.00,0,0.00,12.55,1,0
MBBB,1,0,0.00,0,0.00,20.67,1,0
SMI,1,0,0.00,0,0.00,45.17,1,0
WFIG,1,0,0.00,0,0.00,43.55,1,0
ARCM,0,0,0.00,0,0.00,0.00,0,0
AUGZ,0,0,0.00,0,0.00,0.00,0,0
BUFQ,0,0,0.00,0,0.00,0.00,0,0
CFCV,0,0,0.00,0,0.00,0.00,0,0
DECZ,0,0,0.00,0,0.00,0.00,0,0
DJUN,0,0,0.00,0,0.00,0.00,0,0
DSJA,0,0,0.00,0,0.00,0.00,0,0
DSOC,0,0,0.00,0,0.00,0.00,0,0
DWCR,0,0,0.00,0,0.00,0.00,0,0
EGUS,0,0,0.00,0,0.00,0.00,0,0
EMCA,0,0,0.00,0,0.00,0.00,0,0
EMCH,0,0,0.00,0,0.00,0.00,0,0
EMGC,0,0,0.00,0,0.00,0.00,0,0
EMPW,0,0,0.00,0,0.00,0.00,0,0
EMZA,0,0,0.00,0,0.00,0.00,0,0
ESEB,0,0,0.00,0,0.00,0.00,0,0
ESHY,0,0,0.00,0,0.00,0.00,0,0
EVUS,0,0,0.00,0,0.00,0.00,0,0
FAIL,0,0,0.00,0,0.00,0.00,0,0
FLDZ,0,0,0.00,0,0.00,0.00,0,0
FLTN,0,0,0.00,0,0.00,0.00,0,0
FPAG,0,0,0.00,0,0.00,0.00,0,0
GPAL,0,0,0.00,0,0.00,0.00,0,0
GSEE,0,0,0.00,0,0.00,0.00,0,0
HEET,0,0,0.00,0,0.00,0.00,0,0
HIYS,0,0,0.00,0,0.00,0.00,0,0
HSRT,0,0,0.00,0,0.00,0.00,0,0
HSUN,0,0,0.00,0,0.00,0.00,0,0
ICLO,0,0,0.00,0,0.00,0.00,0,0
IMSI,0,0,0.00,0,0.00,0.00,0,0
IPPP,0,0,0.00,0,0.00,0.00,0,0
ISVL,0,0,0.00,0,0.00,0.00,0,0
JANZ,0,0,0.00,0,0.00,0.00,0,0
JULZ,0,0,0.00,0,0.00,0.00,0,0
JUNZ,0,0,0.00,0,0.00,0.00,0,0
KOCT,0,0,0.00,0,0.00,0.00,0,0
LCF,0,0,0.00,0,0.00,0.00,0,0
MAMB,0,0,0.00,0,0.00,0.00,0,0
MARZ,0,0,0.00,0,0.00,0.00,0,0
MAYZ,0,0,0.00,0,0.00,0.00,0,0
MIG,0,0,0.00,0,0.00,0.00,0,0
NOVZ,0,0,0.00,0,0.00,0.00,0,0
OCTZ,0,0,0.00,0,0.00,0.00,0,0
PBDM,0,0,0.00,0,0.00,0.00,0,0
PLRG,0,0,0.00,0,0.00,0.00,0,0
PLTL,0,0,0.00,0,0.00,0.00,0,0
PSCJ,0,0,0.00,0,0.00,0.00,0,0
PSCQ,0,0,0.00,0,0.00,0.00,0,0
PSCW,0,0,0.00,0,0.00,0.00,0,0
PSCX,0,0,0.00,0,0.00,0.00,0,0
PSFJ,0,0,0.00,0,0.00,0.00,0,0
PSFM,0,0,0.00,0,0.00,0.00,0,0
PSFO,0,0,0.00,0,0.00,0.00,0,0
PSMD,0,0,0.00,0,0.00,0.00,0,0
PSMJ,0,0,0.00,0,0.00,0.00,0,0
PSMO,0,0,0.00,0,0.00,0.00,0,0
PSMR,0,0,0.00,0,0.00,0.00,0,0
QCON,0,0,0.00,0,0.00,0.00,0,0
QTAP,0,0,0.00,0,0.00,0.00,0,0
QTOC,0,0,0.00,0,0.00,0.00,0,0
ROCI,0,0,0.00,0,0.00,0.00,0,0
RTAI,0,0,0.00,0,0.00,0.00,0,0
SEIQ,0,0,0.00,0,0.00,0.00,0,0
SELV,0,0,0.00,0,0.00,0.00,0,0
SNPD,0,0,0.00,0,0.00,0.00,0,0
SNPG,0,0,0.00,0,0.00,0.00,0,0
SNPV,0,0,0.00,0,0.00,0.00,0,0
SPMV,0,0,0.00,0,0.00,0.00,0,0
STLV,0,0,0.00,0,0.00,0.00,0,0
TFJL,0,0,0.00,0,0.00,0.00,0,0
TSJA,0,0,0.00,0,0.00,0.00,0,0
TSOC,0,0,0.00,0,0.00,0.00,0,0
TUSI,0,0,0.00,0,0.00,0.00,0,0
UDEC,0,0,0.00,0,0.00,0.00,0,0
USEQ,0,0,0.00,0,0.00,0.00,0,0
VMAT,0,0,0.00,0,0.00,0.00,0,0
XBAP,0,0,0.00,0,0.00,0.00,0,0
XBJL,0,0,0.00,0,0.00,0.00,0,0
XBOC,0,0,0.00,0,0.00,0.00,0,0
XDAP,0,0,0.00,0,0.00,0.00,0,0
XDJA,0,0,0.00,0,0.00,0.00,0,0
XDJL,0,0,0.00,0,0.00,0.00,0,0
XEMD,0,0,0.00,0,0.00,0.00,0,0
XTAP,0,0,0.00,0,0.00,0.00,0,0
XTJA,0,0,0.00,0,0.00,0.00,0,0
XTJL,0,0,0.00,0,0.00,0.00,0,0
YJUN,0,0,0.00,0,0.00,0.00,0,0
YMAR,0,0,0.00,0,0.00,0.00,0,0